



F        112,    54, 0
  NO     textures/bluestone.xpm

C 255, 0, 0
SO textures/redbrick.xpm
WE textures/eagle.xpm

EA textures/purplestone.xpm



1111111111111111111111111111111111111111111
10000000000001110001011000000000000001000101
100W000000010000000101100000000000011111111
11000010010000000111011111111011100000010111
100000100010001011100110000000010000111 1
11111110001011111111111111101111011111
       111 1               1    1   11   1
