
 F     202,144,108    
WE   ./textures/we.xpm




                  NO       ./textures/no.xpm        
SO    ./textures/so.xpm

EA   ./textures/ea.xpm         

C     79,     137    , 231

        1111111111111111111111111
        1000000000110000000000001
        1011000001110000000000001
        1000000001010000000000001
111111111011000001110000000000001
10000000011000001110111111111111
11110111111111011100000010001
11110111111110001101010010001
11000001110101011100000010001
10000000000000001100000010001
1000000W000000001101010010001
110000011101010111110111100011
11110111 1100101 101111010001
1111111 1111111  111111111111
           
             
