111111111111
1000000E0001
111111000001
100000011111
111111111111
