111111111111
1E0010000001
111111110001
1P0000000111
111111111111
