111111111111
1000000E0001
111111000001
1P0000011110
111111111111
