111111111111111111111
1000000E00000CCC11111
1111110000010000000C1
1P0000011111C0C100001
111111111111111111111
