11111111111111111
10000CC1111E11111
1P000110011011111
111000000000110C1
1C000110C01000011
10000000000000001
11111110001110011
10000000000000001
1111C00000C1C0001
11111111000011111
10000001011011111
10000000000111111
1C0001110C0100001
11111111111111111
